11111111111111111111
10000000000000000001
10000011110000000001
1000000C111111000001
1000000M0E0P00000001
10000000111111000001
11111111111111111111