11111111111111111111
10000000000000000001
100000111100000M0001
1000000C111111000001
1000000M0E0P000MM001
10000000111111000001
11111111111111111111